1111111111
1P00000001
1000111101
1000E00111
1011111011
1000000001
1110C00111
1111011111
1000000001
1111111111