1111111111111111111111
1P000000C1010111011111
10C1011001111101C00111
1100000000011100000111
1001010000010000010111
110001000000C100011111
1000000000001010001111
1010100011001001011111
1000011001101000010111
1110110001110101000111
11C0000000110111001111
1010100000000011011111
1110101100111000001111
101000011110100000C111
101C000011110001011111
11C0000000000000001111
11111101001010E1010111
1101000101001000011111
1110000000011100001111
1110000000011100001111
1111111111111111111111
