1111111111111111111111111111111111
10EP000000000000000000000000000011
1110010100100000101001000000010111
1010010010101010001001010000010101
1000000000000000000000000C00000011
1111111111111111111111111111111111
