1111111111111111111111111111111111
110P000000000000000000000000000011
1111010100100000101001000000011111
1010010010101010001001010000010001
1000000000000000000000000C000000E1
1111111111111111111111111111111111
