111111111111111111111111111111
1P0000000000C10000111100010111
110001000111011010001101011111
101001011011010100001000C10111
111C11110101100011100011010001
110000000000001100110010010011
111001101000011010101111011011
110100111010000000C10001000111
110010010000011110111101000001
110100100010110010111000010011
101100111000101110101011010011
111110000010011101000000000111
110101010010111001011001011111
101000001010100100100110001111
101011000010101110001011010001
110010110010000000110111010101
110C00000000101101100001001011
111001110000000000000011011001
111100101111101001010000000011
111100101010110000100000000C11
101100000101110110000001011111
1001C0000001000011000110011011
111011111001011101011001010101
110C00000000000000000000000101
1100011110000010110110010000E1
100110100000110100111010000101
101001001001111111110100100001
100001011101010000010110101101
111000010110001010100011100001
111111111111111111111111111111
